ID	Name
afr	Afrikaans
ara	Arabic
cmn	Mandarin (Putonghua)
dan	Danish
deu	German
ell	Greek
eng	English
fra	French
hat	Haitian Creole
heb	Hebrew
hun	Hungarian
isl	Icelandic
ita	Italian
jam	Jamaican Creole
jpn	Japanese
kor	Korean
mlt	Maltese
msa	Malay
nld	Dutch
pot	Portuguese
slv	Slovenian
spa	Spanish
swa	Swahili
tsn	Setswana
tsn	Setswana (Tswana)
tur	Turkish
xho	Xhosa
yue	Cantonese
